Reading from file ../data/ascii.ply
Finished reading header, found 453113 vertices, 834218 faces, 0 edges
Finished reading 453113 vertices into memory
xmax: 9.4485	xmin: 0.2908
ymax: 3.7350	ymin: -9.2073
zmax: 2.9550	zmin: -0.9150
0	0	0	0	0	0	0	0	0	1667	2505	599	0	0	0	0	0	0	0	0
0	0	0	0	0	0	0	0	0	1966	903	1419	1368	0	0	0	0	0	0	0
0	0	0	0	0	0	0	0	1046	1324	1190	1021	2131	1990	0	0	0	0	0	0
0	0	0	0	0	0	0	0	2535	1184	1490	1331	1768	2797	3403	0	0	0	0	0
1	2484	896	0	0	0	0	1129	2023	1843	1318	1520	1617	3938	4952	2782	58	0	0	0
1207	1057	1855	1450	1385	1649	0	2238	1171	1314	1233	897	1706	5704	2109	1490	2429	158	0	0
1885	697	717	1388	2986	3241	2272	2275	2526	3417	1712	1375	3241	4351	1690	1133	707	1895	709	0
2430	641	517	654	848	1564	4626	5796	2540	3199	2349	854	5481	1046	902	1047	669	559	961	0
2684	657	465	518	875	1284	3038	7003	5267	2971	2620	1753	4355	1183	722	1066	991	2144	0	0
478	3296	2291	614	908	1287	1258	3791	4956	5106	3535	5209	2129	1439	1173	919	818	1970	0	0
0	0	3041	962	907	1110	1194	1097	2024	1658	1705	7426	1712	2100	1661	1374	1533	580	0	0
0	2	3832	720	4788	2599	725	867	1313	1452	1047	3469	3008	2296	1760	478	1767	0	0	0
0	1221	2903	2197	1492	3980	869	1111	1206	1843	1347	817	3514	4638	1524	408	1453	0	0	0
0	2492	999	3230	0	337	2017	1115	1537	1329	961	986	1171	2542	5340	2251	0	0	0	0
0	2123	1514	2190	0	0	35	1763	1856	1575	884	1647	1870	1035	1189	3065	632	0	0	0
607	1568	1803	333	0	0	0	47	2385	4589	1283	1890	4106	3433	750	660	2048	1011	0	0
1	172	1587	0	0	0	0	0	0	2557	4790	2787	3459	390	2703	1896	639	1701	1390	0
0	0	93	0	0	0	0	0	0	0	2083	3325	483	0	0	1704	3216	890	1144	297
0	0	0	0	0	0	0	0	0	0	0	141	14	0	0	0	879	3420	790	325
0	0	0	0	0	0	0	0	0	0	0	0	0	0	0	0	0	39	2064	283
Reading from file ../data/ascii.ply
Finished reading header, found 453113 vertices, 834218 faces, 0 edges
Finished reading 453113 vertices into memory
xmax: 9.4485	xmin: 0.2908
ymax: 3.7350	ymin: -9.2073
zmax: 2.9550	zmin: -0.9150
